11111
1PE11
1E011
1C111
11111
