111111111111111
110E01000000001
100100000000001
100P00000011001
111011000011101
100100000011101
101110000E00001
100100000000E01
1110110000E0001
1C000C000000001
110101000E00001
111111111111111
