11111111111111111111111111111111111111
1CCC0000CCCCC00000CCCCCCCC00000CCCCCC1
1CCC0000CCECCCCC000CCCCCC0000000CCCCC1
1CCCCCCCCCC11CC00000000000000CCCCCCCC1
1C000C000000000CCXCCCCC11CCC00CCCCCCC1
1CC000000CCCCCCC0000CCCC0000CCCCCCCCC1
10000CCCPCCCCC0000CCCC0000000000CCCCC1
1C0000000000000000000000000000000000C1
1C0000000000000000000000000000000000C1
1C0000000000000000000000000000000000C1
1C0000000000000000000000000000000000C1
1C0000000000000000000000000000000000C1
1C0000000000000000000000000000000000C1
1C0000000000000000000000000000000000C1
1C0000000000000000000000000000000000C1
1C0000000000000000000000000000000000C1
1C0000000000000000000000000000000000C1
1C0000000000000000000000000000000000C1
1C0000000000000000000000000000000000C1
1C0000000000000000000000000000000000C1
1C0000000000000000000000000000000000C1
1C0000000000000000000000000000000000C1
1C0000000000000000000000000000000000C1
1C0000000000000000000000000000000000C1
1C0000000000000000000000000000000000C1
1C0000000000000000000000000000000000C1
1C0000000000000000000000000000000000C1
1C0000000000000000000000000000000000C1
1C0000000000000000000000000000000000C1
1C0000000000000000000000000000000000C1
1C0000000000000000000000000000000000C1
1C0000000000000000000000000000000000C1
1C0000000000000000000000000000000000C1
1C0000000000000000000000000000000000C1
1C0000000000000000000000000000000000C1
1C0000000000000000000000000000000000C1
1C0000000000000000000000000000000000C1
1C0000000000000000000000000000000000C1
1C0000000000000000000000000000000000C1
1C0000000000000000000000000000000000C1
11111111111111111111111111111111111111