111111111111111111111111
100000000000000000000001
101111111111111111111101
101110011001100E00000101
101100111001111111100101
101001111001111111100101
10100000P001100000000101
101111111001100111111101
100000001001100111111101
100000C0100110000C000101
100000001001100000000101
100000000000000000000001
111111111111111111111111