1111111111111111111
1000000000000000001
1011011101011101101
1011011101011101101
1001000000000001001
1101010111110101011
1000010001000100001
1011111101011111101
1000000000000000001
1011100110110011101
10101001C0P10010101
101E000111110000101
1010100000000010101
1011100111110011101
1000000001000000001
1011011101011101101
1001000000000001001
1101010111110101011
1000010001000100001
1011111101011111101
1000000000000000001
1111111111111111111
